20 20
300 300
8 8 8 8 9 9 8 9 8 9 8 8 9 9 8 9 8 9 9 8
9 9 8 8 9 8 9 9 8 8 9 8 9 8 9 8 8 9 9 9
9 9 0 0 0 0 0 8 8 0 0 0 0 0 0 0 0 9 8 9
8 8 0 0 0 0 0 0 0 0 0 0 0 0 0 0 0 0 9 8
8 0 0 0 0 4 3 3 3 5 0 0 0 0 8 9 0 0 0 9
9 0 0 0 0 0 0 0 0 6 5 0 0 0 0 0 0 0 0 9
9 0 0 0 0 0 0 0 0 0 6 5 0 0 0 0 0 0 0 8
8 0 0 0 1 0 0 0 0 0 0 6 5 0 0 2 2 2 2 2
8 0 0 1 1 0 0 0 0 0 0 0 6 7 0 1 1 1 1 2
9 0 0 0 0 2 0 8 8 0 0 0 0 0 0 2 2 2 2 2
8 0 0 0 2 0 0 0 9 0 0 0 0 0 0 0 0 0 0 9
9 0 0 0 0 0 0 0 0 0 0 0 0 0 1 0 0 0 0 9
8 0 4 3 3 5 0 2 2 2 2 0 0 0 1 0 0 0 0 8
8 0 0 0 0 6 7 2 1 1 1 0 0 0 1 0 0 0 0 8
9 0 1 0 0 0 0 2 1 2 1 0 0 0 1 0 0 0 8 9
9 0 1 2 2 2 2 2 1 2 1 1 1 1 1 0 0 9 8 8
8 8 1 1 1 1 1 1 1 2 1 0 0 0 0 0 9 9 8 9
9 9 9 0 0 2 2 2 2 2 1 0 0 0 0 8 8 9 9 8
9 9 8 8 9 8 9 9 8 8 9 8 9 8 9 8 8 9 9 9
8 8 8 8 9 9 8 9 8 9 8 8 9 9 8 9 8 9 9 8